111111111111111
1E00QC000000011
111001Q1001Q0Q1
111Q01C100QC0Q1
10C0010100Q0Q11
1011110100Q0QQ1
1P00000000Q00C1
111111111111111
