11111111111
1E00QC000Q1
11100100001
111001C0001
10C00100001
10111100Q01
1P000000001
11111111111
